1111111111111
100100C000C11
10C0011000001
1P01E00C00011
1111111111111
