1111111111111
100100Cc00C11
10C0011111001
1P011E00C0011
1111111111111
