1111111111111
1001000000011
1000000110001
1P01E0000C011
1111111111111
