1111111111111111111111111111111111
1E0000000000000C00000C000000000001
1010010100100000101001000000010101
1010010010101010001001000000010101
100000000C00C0000000000000000000C1
100000001000000100000C000000000011
1000C00000011000000000010000C00001
1000P00010001000000010000100010001
1111111111111111111111111111111111
