1111111111111
10C100000C011
10C00P0110001
1CE00000C0111
1111111111111
