1111111111111
10C100000C011
10C0000110001
1P10E0000C011
1111111111111
