1111111111111
100100000C011
1000000110001
1P10E0000C011
1111111111111
